0000000000000000000000000000000000000000000000000000000000000000000000000000000000000000000000000000000000000000000000000000000000000000000000000000000000000000000000000000000000000000000000000000000000000000000000000000000000000000000000000000000000000000
0000000000000000000000000000000000000000000000000000000000000000000000000000000000000000000000000000000000000000000000000000000000000000000000000000000000000000000000000000000000000000000000000000000000000000000000000000000000000000000000000000000000000000
0000000000000000000000000000000000000000000000000000000000000000000000000000000000000000000000000000000000000000000000000000000000000000000000000000000000000000000000000000000000000000000000000000000000000000000000000000000000000000000000000000000000000000
0000000000000000000000000000000000000000000000000000000000000000000000000000000000000000000000000000000000000000000000000000000000000000000000000000000000000000000000000000000000000000000000000000000000000000000000000000000000000000000000000000000000000000
0000000000000000000000000000000000000000000000000000000000000000000000000000000000000000000000000000000000000000000000000000000000000000000000000000000000000000000000000000000000000000000000000000000000000000000000000000000000000000000000000000000000000000
0000000000000000000000000000000000000000000000000000000000000000000000000000000000000000000000000000000000000000000000000000000000000000000000000000000000000000000000000000000000000000000000000000000000000000000000000000000000000000000000000000000000000000
2222220000000000000000000000000000000000000000000000000000000000000000000000000000000000000000000000000000000000000000000000000000000000000000000000000000000000000000000000000000000000000000000000000000000000000000000000000000000000000000000000000000000000
1111110000000000000000000000000000000000000000000000000000000000000000000000000000000000000000000000000000000000000000000000000000000000000000000000000000000000000000000000000000000000000000000000000000000000000000000000000000000000000000000000000000000000
1111110000000000000000000000000000000000000000000000000000000000000000000000000000000000000000000000000000000000000000000000000000000000000000000000000000000000000000000000000000000000000000000000000000000000000000000000000000000000000000000000000000000000
1111110000000000000000000000000000000000000000000000000000000000000000000000000000000000000000000000000000000000000000000000000000000000000000000000000000000000000000000000000000000000000000000000000000000000000000000000000000000000000000000000000000000000
1111112200000000000000000000000000000000000000000000000000000000000000000000000000000000000000000000000000000000000000000000000000000000000000000000000000000000000000000000000000000000000000000000000000000000000000000000000000000000000000000000000000000000
1111111122000000000000000000000000000000000000000000000000000000000000000000000000000000000000000000000000000000000000000000000000000000000000000000000000000000000000000000000000000000000000000000000000000000000000000000000000000000000000000000000000000000
1111111111222000000000000000000000000000000000000000000000000000000000000000000000000000000000000000000000000000000000000000000000000000000000000000000000000000000000000000000000000000000000000000000000000000000000000000000000000000000000000000000000000000
11111111111110000000000000000000000000000000000000000000000000000000000000000000000000002222222222220000000000000000000000000000000000000000000000000000000S0000000000000000000000000000000000000000000000000000000000000000000000000000000000000000000000000000
1111111111111000000000000000000000000000000000000000000000000000000000000000000000000002111111111111200000000000000000000000000000000000S00000000000000000SSS000000000000000000000000000000000000000000000000000000000000000000000000000000000000022222222222222
111111111111000000000000000000000000000000000000000000000000000000000000000000000000022111111111111112000000000000000000000000000000000SSS0000000S0000000SSsSS00000000000000000000000000000000000000000000000000000000000000000000000000000000000211111111111111
11111111111124000000000000000000000000000000000000000000000000000000000000000000000021116111111111111100000000000000000000000000000000SSsSS00000SsS00000SSsssSS0000000000000000000000000000200000000000000000020000000000000000000000000000000000111111111111111
1111111111111220000000000000000000000000000000000000000000000000000000000000000000221168881111111111110000000000000000000000000000000SSsssSS0000SSS0000SSssssssSS00000000000000000000000022122222222222222222212222222222200000000000000000000000111111111111111
11111111111111120000000000000000000000000000000000000000000000000000000000000000021111888881111111111100000000000000000000000000000000SsssS00000SssS0000SsssssS0000000000000000000000000211111111111111111111111111111111100000000000000000000000111111111111111
1111111111111111200000000000004000000000000000000000000000000000000444400000000021111111188811111111120000000000000000000000000000000SSsssS000SSsssSS000Sssss0SS000000000000000000000002111111111111111111111111111111111100000000000000000000000111111111111111
111111111111111112222222228882222222222222222222222222222w22222222222222222222221111111111wwww1111111122222222220000000000000000000000gsgsSSSSSssgssSSSSSssgssg000000000000002000000000ccccccccccccccccccccccccccccccccccc00000000000000000000002111111111111111
111111111111111111111111188821111111111111111111111111111w111111111111111111111111111111111wwwww11188111111111112000000000000000000000SsssSsssssgggsssssssssssS00000000000000c000000000000ccccccccccccccccccccccccccccccc000000000000000000000021111111111111111
111111111111111111111111688211111111111111111111111111111w111111111111111111111111111111wwwwwwwww1wwww11111111111000000000000020000000sssssssssssssssssssssssss00000020000020000000000000000cccccccccccccccccccccccccccc0000000000000000000000211111111111111111
111111111111111111111111882111111111111111111111111111111w111111111111111111111111111111wwwwwww1wwwwww1111111111122wwww22222221222222222222222222222222222222222222221222221200000000000000000000000000000000000000000000000000000000000000000111111111111111111
111111111111111111111111881111111111111111111111111111111w111111111111111111111111111111ww11www1ww11wwwwwwwwww11wwwwwww11111111111111111111111111111111111111111111111111111120000000000000000000000000000000000000000000000000000000000000000111111111111111111
111111111111111111111118821111111111111111111111111111111w111111111111111111111111111111111wwwwww111111wwwwwwwwwwwwwwww11111111111111111111111111111111111111111111111111111112wwwwwwwwwwwwwwwwwwwwwwwwwwwwwwwwwwwwwwwwwwwwwwwwwwwwwwwwwwwwww2111111111111111111
111111111111111111111118888888868888811111111111111111111w11111111111111111111111111118881www1111111111111111wwwwwwwww111111111111111111111111111111111111111111111111111111111wwwwwwwwwwwwwwwwwwwwwwwwwwwwwwwwwwwwwwwwwwwwwwwwwwwwwwwwwwwwww1111111111111111111
111111111111111111111114888848888888888888111118888811111w111111111111111111111111111181wwwww1111111111111111ww1111111111111111111111111111111111111111111111111111111111111111wwwwwwwwwwwwwwwwwwwwwwwwwwwwwwwwwwwwwwwwwwwwwwwwwwwwwwwwwwww221111111111111111111
11111111111111111111111122221222888888888888888w118881111w111111111111111111111111111181111111111111111111111ww11111111111111111111111111111111111111111111111111111111111111112wwwwwwwwwwwwwwwwwwwwwwwwwwwwww2wwwwwwwwwwwwwwwwwwwwwww2www2111111111111111111111
11111111111111111111111111111111222444888888888w888888811w111111111111111111111111111181111111111111111111111ww11111111111111111111111111111111111111111111111111111111111111111214wwwwwwwwwwwwwwwwwwwwwwwww2212222222222222222222222212221111111111111111111111
11111111111111111111111111111111111111188888888w888222881w111111111111111111111111111181111111111111111111111ww1111111111111111111111111111111111111111111111111111111111111111111112222222222222222222222111111111111111111111111111111111111111111111111111111
11111111111111111111111111111111111111188888222w888111181w11111111111111111111111111118111111111111111111111www1111111111111111111111111111111111111111111111111111111111111111111111111111111111111111111111111111111111111111111111111111111111111111111111111
111111111111111111111111111111111111111888888888888111188w1111111111111111111111111111811111111111111111111www11111111111111111111111111111111111111111111111111111111111111111111111111111111111111111111111111111111111111111111111111111111111111111111111111
11111111111111111111111111111111111111184844444448811112211111111111111111111111111111811111111111111111111wwwww111111111111888881111111111111111111111111111111111111111111111111111111111111111111111111111111111111111111111111111111111111111111111111111111
1111111111111111111111111111111111111111111111111111111111111111111111111111111111111181111111111111111111wwwwwww11118888888888888888886111111111111111111111111111111111111111111111111111111111111111111111111111111111111111111111111111111111111111111111111
1111111111111111111111111111111111111111111111111111111111111111111111111111111111111181111111111111111111ww111www1118888888844488888884111111111111111111111111111111111111111111111111111111111111111111111111111111111111111111111111111111111111111111111111
11111111111111111111111111111111111111111111111111111111111111111111111111111111111111811111111111111111111111111wwwww111111111111111111111111111111111111111111111111111111111111111111111111111111111111111111111111111111111111111111111111111111111111111111
11111111111111111111111111111111111111111111111111111111111111111111111111111111111168811111111111111111111111111111w1111111111111111111111111111111111111111111111111111111111111111111111111111111111111111111111111111111111111111111111111111111111111111111
11111111111111111111111111111111111111111111111111111111111111111111111111111111118888811111111111111111111111111111w1111111111111111111111111111111111111111111111111111111111111111111111111111111111111111111111111111111111111111111111111111111111111111111
11111111111111111111111111111111111111w11888888888888888888888888888888888888881188111811111111111111111111111111111w1111111111111111111111111111111111111111111111111111111111111111111111111111111111111111111111111111111111111111111111111111111111111111111
11111111111111111111111111111111111111818888888888888888888888888888888888888888888811411111111111111111111111861111w1111111111111111111111111111111111111111111111111111111111111111111111111111111111111111111111111111111111111111111111111111111111111111111
11111111111111111111111111111111111111888888888888888884488888888888888888888888881811111111111111888888888888888881w1111111111111111111111111111111111111111111111111111111111111111111111111111111111111111111111111111111111111111111111111111111111111111111
111111111111111111111111111111111111111111111w11111111111111111111w11111111111111118111111111111118811111111111111www1111111111111111111111111111111111111111111111111111111111111111111111111111111111111111111111111111111111111111111111111111111111111111111
111111111111111111111111111111111111111111111w11111111111111111111w111111111111111188888888888888881111111111111111111111111111111111111111111111111111111111111111111111111111111111111111111111111111111111111111111111111111111111111111111111111111111111111
1111111111111111111111111111111111111111111111111111111111111111111111111111111111111111111111111111111111111111111111111111111111111111111111111111111111111111111111111111111111111111111111111111111111111111111111111111111111111111111111111111111111111111
1111111111111111111111111111111111111111111111111111111111111111111111111111111111111111111111111111111111111111111111111111111111111111111111111111111111111111111111111111111111111111111111111111111111111111111111111111111111111111111111111111111111111111
1111111111111111111111111111111111111111111111111111111111111111111111111111111111111111111111111111111111111111111111111111111111111111111111111111111111111111111111111111111111111111111111111111111111111111111111111111111111111111111111111111111111111111