
      00000000000000000000000000000000000000000000000000000000000000000000c0000000000000000000000000000000000000000000
      0000000000000000000000000000000000000000000000000000000000000000000ccc000000000000000000000000000000000000000000
      00000000000000000000000000000000000000000000000000000000000000000000c0000000000000000000000000000000000000000000
      00000000000000000000000000000000000000000000000000000000000000020000c0000000000000000000000000000000000000000000
      0000000000000000000000000000000000000000000000000000000000000021222222222220000000000000000000000000000000000000
      00000000000000000000000000000000000000000000000000000000000ww2c1111111111cc0000000000000000000000000000000000000
      0000000000000000000000000000000000000000000000000000400000000ccccccccccccc00000000000000000000000000000000000000
      000000000000000000000000000000000000000000000000000220000000000cccccccccc000000000000000000000000000000000000000
000000000000000000000000000000000000000000000000000004400000000000000ccc0000cc0000000000000000000000000000000000000000
222222000000000000000000000000000000000000020000000002200000000000000000000000000000000000000000000000000000000000000000000404
11111122000000000000000000000000000000000000000000000000000000000000000000000000000000000000000000000000000000000000000000222222222
11111111200400000000000000000000000000000000000020000000000000000000000000000000000000000000000000000000000000000000000002111111111
11111111122220000000000000000000000000000000000000000000000000000000000000000000000000000000000000000000000000000000000021111111111
11111111111110000000000000000000000040000000000000020000000000000000000000000000000000000000000000000000000000000000000211111111111
11111111111110000000000000000000000422000000000000000000000000000000000000000000000000000000000000000000000000000000002111111111111
11111111111112000000000000000000004211200000000000000020000000000000000000000000000000000000000000000000000000000000001111111111111
11111111111160000000000000000000002111120000000000000000000000000000000000000000000000000000000000000000000000000000001111111111111
11111111111111000000000000000000000111112000000000000000200000000000000000000000000000000000000000000000422222000000021111111111111
11111111111111200000000000000000000111111200000000000000000000000400044020000000000000044400400000000042211111220000211111111111111
1111111111111112222288822222222222211111112wwww22222222222222222222222221000000000000022228822222222222111111111w222111111111111111
1111111111111111111188811111111111111111111www111111111111111111111111111220000000000211118811111111111111111111w111111111111111111
1111111111111111111188811111111111111181111www111111111111111111111111111110000000002111118811111111111111111111w111111111111111111
1111111111111111111188811111111111111188881www111111111111111111111111111110000000021118888811111111111111111111w111111111111111111
1111111111111111111188811111111111111188881ww1111111111111111111111111111112202200411888488811111111111111111111w111111111111111111
11111111111111111111888111111111111111222w1w11111111111111111111111111111111121122218881111111111111111111111111w111111111111111111
11111111111111111111888111111111111133333wwww1111111111111111111111111111111111111188411111111111111111111111111w111111111111111111
11111111111111111111888111111111111333333wwwwww11111111111111111111111111111111111188111111111111111111111111111w111111111111111111
1111111111111111111188811111111111133333333wwww11111111111111111111111111111111111118811111111111111111111111111w111111111111111111
3333333333333333333399933333333333333333333w33333333333333333333333333333333333333339999333333333333333333333333w333333333333333333
3333333333333333333399933333333333333333333w33333333333333333333333333333333333333339993333333333333333333339999w333333333333333333
3333333333333333333399933333333333333333333w33333333333333333333333333333333333333333993333333333333333333339999w333333333333333333
3333333333333333333399933333333333333333333w3333333333333333333333333333333333333333399333333333333333333333w3333333333333333333333
3333333333333333333399933333333333333333333w3333333333333333333333333333333333333333399333333333333333333333w3333333333333333333333
3333333333333333333399933333333333333333333w3333333333333333333333333333333333333333399333333333333333333333w3333333333333333333333
3333333333333333333399933333333333333333333w3333333333333333333333333333333333333333399333333333333333333333w3333333333333333333333
3333333333333333333399933333333969999999999w3333333333333333333333333333333333333333399999999966999999999933w3333333333333333333333
3333333333333333333399999999996999999999999w3333333333333333333333333333333333333333399999999999999999999933w3333333333333333333333
3333333333333333333399999999999999399999999w3333333333333333333333333333333333333333399333339999933333333933w3333333333333333333333
3333333333333333333333333939499933344444433w3333333333333333333333333333333333333333344333334444433333333999w3333333333333333333333
33333333333333333333333333333399333333333334333333333333333333333333333333333333333333333333333333333333333333333333333333333333333
33333333333333333333333333333399333333333333333333333333333333333333333333333333333333333333333333333333333333333333333333333333333
33333333333333333333333333333399333333333333333333333333333333333333333333333333333333333333333333333333333333333333333333333333333
33333333333333333333333333333344333333333333333333333333333333333333333333333333333333333333333333333333333333333333333333333333333
33333333333333333333333333333333333333333333333333333333333333333333333333333333333333333333333333333333333333333333333333333333333
33333333333333333333333333333333333333333333333333333333333333333333333333333333333333333333333333333333333333333333333333333333333
33333333333333333333333333333333333333333333333333333333333333333333333333333333333333333333333333333333333333333333333333333333333


